....#####
....#---#..........
....#K--#..........
..###--K##.........
..#--K-K-#.........
###-#-##-#...######
#---#-##-#####--ZZ#
#-K--K----------ZZ#
#####-###-#B##--ZZ#
....#-----#########
....#######........