######
#-B--#
#--#-#
#-KK-#
#-K-##
###-#
.#Z-####
.#Z----#
.#Z----#
.#######
